XXXXXXXXXXXX
E.X........X
X.X.XXXX.X.X
X.X.X....X.X
X.X.X.XX.X.X
X.X.X.X@.X.X
X.X.X.XXXX.X
X.X......X.X
X.XXXXXXXX.X
X..........X
XXXXXXXXXXXX